............................
............................
............................
..xx...xx...xx...xx...xx....
..xx...xx...xx...xx...xx....
..xx...xx...xx...xx...xx....
..xx...xx...xx...xx...xx....
..xx...xx...xx...xx...xx....
..xx...xx...xx...xx...xx....
..xx...xx...xx...xx...xx....
..xx...xx...xx...xx...xx....
............................
............................
............................
...xx...xx...xx...xx...xx...
...xx...xx...xx...xx...xx...
...xx...xx...xx...xx...xx...
...xx...xx...xx...xx...xx...
...xx...xx...xx...xx...xx...
...xx...xx...xx...xx...xx...
...xx...xx...xx...xx...xx...
...xx...xx...xx...xx...xx...
............................
............................
............................
...xx...xx...xx...xx...xx...
...xx...xx...xx...xx...xx...
...xx...xx...xx...xx...xx...
...xx...xx...xx...xx...xx...
...xx...xx...xx...xx...xx...
...xx...xx...xx...xx...xx...
...xx...xx...xx...xx...xx...
...xx...xx...xx...xx...xx...
............................
............................
............................
...gg...gg...gg...gg...gg...
